Arachibutyrophobia — Fear of peanut butter sticking to the roof of your mouth.
Artificial Stimulant Indoctrinaire — Junky.
Constitutionally Incapacitated Swashbuckler — Coward.
Cerebral Embryo — Brainchild.
Cerebration — Thinking for the sake of thinking (sort of like masturbation, only it's for that other thing you use to think with).
Entertainment Liaison Agent — Pimp.
Eurotophobia — Fear of female genitals.
Helminthophobia — Fear of becoming infested with worms.
Parousiamania — An abnormal anticipation of the Second Coming of Christ.
Penis — From Latin, meaning "tail."
Porphyrophobia — Hatred of the colour purple.
Rapere Diem — Latin for "Rape the day."
Sheryl Crow — The second coming of Edie Brickell.
Spacially Challenged — Contortionist.
Vagina — From Latin, meaning "sword sheath" (just proves that slang really can be accepted).
Anthropophagous- Eating someone else (let your imagination roam).
Curmudgeon- There's two meanings to this word. The first, as listed by Webster's is "a bad-tempered, churlish man." It has been increasingly used in a more modern way, however: "anyone who hates hypocrisy and pre- tense and has the temerity to say so; anyone with the habit of pointing out unpleasant facts in an engaging and humorous manner." I guess you could classify Mark Twain and Harlan Ellison as curmudgeons.
Democratic cult- second coming of Christ, passed by a two thirds majority.
Gwabug — I don't know. Your guess is as good as mine, but my mom always used it. All she said was that they (whatever THEY are) "Gwa".
Intellectual myopia — lacking the ability, or desire, to stop being an idiot.
Keep Your Eyes Peeled- Eeeewwwww (I've never had the need to spell this before). What a wretched thought. Who came up with this one...and more important...WHY!?
Spoonerism — A transposition of letters in a sentence. An example of this verbal phenomena is when, raising a glass to toast the Queen of England, Spooner (its namesake) said, "Let's glaze our asses in salute to our queer Dean." He got into no trouble, only because he said rather embarrassing things all the time. As a side note, one of our writers (yes, there's more than one crack pot. So "Luke, join us. It is your destiny.") has a number of English descendants who have the sir name "Spooner". The phenomena seems to be genetic.
Strapping Young Man — What the hell does this MEAN! Does he liked to be strapped? Does he like to strap? What? What? What! Is he built like a backpack?! Tell me!!!
Verbal bulimia — Saying the same damn crap you puke up every day because you can't think of any thing original to say (example: "What's up?" When you ask that question, do you really care? People say it as a sign that they are willing to interact; it's a kind of door-charge. Isn't it easier to say "Hi"?).
Verbal dysentery — The act of speaking when one has nothing to say.
Anal Explosive — opposite of anal retentive (Look Out!).
Argocious — 1) Being overly abundant in praise of one's self and having no justification to do so. 2.) Being a common idiot and professing to know the nature of the world.
Bombastic- Using words larger than necessary to describe things that are smaller than you think they are.
Defenestrate — To throw an object, or person, living or non-living, out of a window.
Dullard — Someone who can open an encyclopedia or dictionary and only read what they'd planned to.
Godphiles — Kind of like pediphiles, but more like priests.
Groin — A massive wooden framework or low broad wall of concrete or masonry run out from a shore especially to combat erosion.
Example: "Mom, I'm going swimming near the groin."
Kludge — A ridiculous assortment of unmatched and unworkable parts.
Misanthropology — The study of why people are so stupid and why most of them should die...soon.
Non-Committal Epileptic — Those people who, when in the presence of music, aren't quite comfortable enough to dance, so in its stead they twitch a portion of their anatomy, not necessarily to any human concept of beat.
Pasgang — Striding with a forward kick and a pole push on the same side.
Relaxed Bisexual Agnostic — I don't know, I don't care, and maybe I'll sleep with it.
Snake — Not so much a pet as an ambitious plant. What's the difference, really? You just feed them, but the snake ends up behind the fridge while the plant tends to stay where you put it.
Stultify — To cause to be ridiculous Xerophthalmia- Abnormal dryness of the eyeball.
Xerophthalmia — Abnormal dryness of the eyeball.
Advocodocating — When words spontaneously increase in length. It is a rare disease,
though, strangely prevalent among the GDT staff.
Anti-paranoia — That eerie feeling that nothing is connected to anything else. 
Arborealophobia — Fear of tree-like things.
Baboonery — Kind of like a nunnery, but with baboons. I don't know....
Dark Blader — aka Dark Man. That guy at RIT who rollerblades about campus (badly) wearing a cloak ("...together, we can end this destructive conflict and rule the campus as father and son") (please note that this was written two weeks before this year’s Distorter came out).
Dimensionally Transcendental — Whovians know what we mean. For those deprived souls, it simply means "bigger inside than out."
Flacoxenogeriatrodepilakopfviroducoastrobarquephilia — The love of Patrick Stewart in Star Trek.
Flitterbick- A mythical flying squirrel that flies so fast that no one has ever seen it.
Geriatridepilakopfviroastroducoflacoxenobarqueophilia — The love of Sean Connery in The Hunt for Red October.
Gregarious — Loudly chanting.
Homogeriatriphile — A person attracted to the elderly of the same sex. 
Line-man — Nathan Arnone (Yeah. 2 point. Definitely 2 point).
Lummox — Actually, we're not sure of the spelling or meaning. Someone who throws their mass about the immediate area due to overexcitedness, and a general lack of con- cern as to what/who they knock over.
Militant Agnostic — I don't know and you don't either!
Mouseketeer — A driver of mice (and, when discussing one Mouseketeer in particular, a driver of men).
Muleteer — A driver of mules.
Paradisic — Like paradise, only it clings to the back of your neck, under your hair line. 
Pronoia — that eerie feeling that people are secretly conspiring to do you good. 
Puritanism — The haunting fear that someone somewhere may be happy. Quadragenarian- a person who is 40 years old or over but not yet 50.
Brothel — Six or more unmarried women inhabiting the same house. That's why sorority houses are not permitted on the U of R.
Bundling — To sleep or lie in the same bed without undressing, especially of sweet-hearts, as in early New England. This resulted in a bunch of hasty marriages....
Eschatology — The doctrine of the last or final things, such as death, resurrection, immortality, and judgment.
Flehmenem — Long ropy phlegm that springs back like a window shade when you try to spit or pull it out ("thawpthawpthawpt...").
German — Being the child of one's parent’s own brother or sister. Accept no imitations: always look for the unitooth.
Hammerhead Christians — Those insufferable gits who take the Bible as literal truth. 
Hinduism — Well, Pat Robertson defines it as "devil worship."
Hoof-heads — Those chicks with the really big hair.
Jihad — Yiiyiiyiiyiiyiiyiiiyiiyiyiyiyiyiyiyiyiiyiyiyiyiyiyiyiyi!
Juramentado — A Muhammadan Moro who has taken an oath to die while engaged in killing Christians. See "Jihad."
Lissotrichous — Having straight hair.
Lumbricoid — Resembling an earthworm.
Moolie — We're not really sure just what a moolie is. The important thing is, he's outta here!
The Rapture — The "snatching away of the church." It refers to the immediate departure of hundreds of thousands of people from this earth during a huge, multiple orgasm that will happen in the twinkling of an eye.
Resurrection — The act of exhuming the dead with a shovel and a pig. Rush - Something of little or no value.
Scatology — The study of shit.
Sitomania — Insane mania for food.
Skua — Type of bird that steals prayers. People pray all the time, but God never gets them because skuas snag them from the air and line their nests with them. There is even some evidence that Gud’n Tenshuns come into being from some of these intercepted prayers that are dropped by the birds and fall to earth.
Slinky — The metal or plastic tool posing as a toy that is actually the graph of a complex mathematical equation that describes the upward, otherwise inexplicable, spiral of credit card debt.
Sororate — The marriage of one man with two or more sisters, usually successively, after the first wife has been found to be barren or after her death.
Superfetation — Conception during pregnancy. 
Thanatophobia — Fear of death.
Yuk - The SI unit of laughter.
